000000000000000000000000000000
000000000000000000000000000000
000000022222200000000000000000
000000000000000000000000000000
220000000000000000000000000000
112200000000000000000000000000
111111000000000000000000022000
111122222222222221100002211200
111111111111111111100001111100
111111111111111111100000110000
111111111111111111100000100000
111111111111111111100000100000
111111111111111111100000000000